+++++++++++++++
+adg      0GEC+
++++  +++  ++++
   +  +++  +   
   +  +++  +
++++  +++  ++++
+beh       FDB+
++++  +++  ++++
   +  +++  +
   +  +++  +
++++  +++  ++++
+cfi       IHA+
+++++++++++++++
